111111111
1E00000C1
1CP000C01
111111111
